username: cgarnett0           	password: xpvlhyppkq	email: nwitting@yahoo.com  
username: wnicol1             	password: dqhygagcfv	email: casey65@gmail.com   
username: msnalham2           	password: zivvjsiryv	email: margarette60@gmail.com
username: mcarlyle3           	password: gavainsnqo	email: schmidt.loren@yahoo.com
username: kbosanko4           	password: msuhnixtdw	email: tatum.walsh@yahoo.com
username: ccathesyed5         	password: nduwdtgnbo	email: terence11@yahoo.com 
username: gmcdade6            	password: nezyabwffr	email: melvin53@gmail.com  
username: btitley7            	password: yjcjesjacx	email: ritchie.salvatore@gmail.com
username: hhollyman8          	password: fmgyiwensx	email: cummings.scot@hotmail.com
username: hasch9              	password: moqchfhfwb	email: pankunding@hotmail.com
username: amahodya            	password: wvwyyjfjre	email: haley.trycia@gmail.com
username: jcatleyb            	password: sdtokdrwdh	email: qheller@yahoo.com   
username: amcgibbonc          	password: pllpskwiqk	email: doyle.ramona@gmail.com
username: bcassind            	password: wvnfhxxzik	email: nestor.murray@yahoo.com
username: aloade              	password: ixzkrjfzhy	email: lavonne04@gmail.com 
username: cmedwayf            	password: zobftphzep	email: sedrick.reichel@gmail.com
username: mhyamg              	password: kfpbjvbcky	email: dconsidine@gmail.com
username: bquinlanh           	password: fppirldhxs	email: erdman.lexi@yahoo.com
username: jsharplei           	password: drwvdiwyil	email: fmorar@hotmail.com  
username: smewesj             	password: agyzkzapud	email: pmccullough@yahoo.com
username: aroberdsk           	password: jsejnhpjqp	email: mante.edgar@hotmail.com
username: spitherickl         	password: rriujykjqi	email: margarett45@yahoo.com
username: lcarillom           	password: qkundyqisg	email: bednar.kiara@gmail.com
username: espurdensn          	password: yqtooyktil	email: jamaal.adams@gmail.com
username: hramelo             	password: ecmaxjxxje	email: mbreitenberg@hotmail.com
username: dregisp             	password: hrvhuabzrr	email: bahringer.yolanda@gmail.com
username: ahaynesfordq        	password: jwxxsxeuxz	email: monserrate.bahringer@hotmail.com
username: acourvertr          	password: keleynihuj	email: jessie.corkery@hotmail.com
username: psebrooks           	password: nnnybxjkya	email: gregory.considine@yahoo.com
username: ccordobat           	password: tlziicsmqq	email: obruen@hotmail.com  
username: jfennessyu          	password: ndafgfgnwv	email: ferry.hector@hotmail.com
username: eduxburyv           	password: rwapmkvpgy	email: ywolf@yahoo.com     
username: mbrackpoolw         	password: iqefwidlmt	email: luettgen.akeem@hotmail.com
username: mbickardikex        	password: ebwupyyanr	email: earline11@hotmail.com
username: khouchiny           	password: hynkrxwvnv	email: qheathcote@yahoo.com
username: eegglestonez        	password: goibjteiuo	email: zgorczany@hotmail.com
username: tpawlett10          	password: sfkcssunxa	email: renee.price@hotmail.com
username: ocrippin11          	password: lkmrnfxpir	email: hailey03@hotmail.com
username: tmcdill12           	password: natjqjappj	email: ylegros@hotmail.com 
username: bpedracci13         	password: iygbwixasj	email: wehner.mohammed@gmail.com
username: kgerholz14          	password: omruqhaxub	email: holly.funk@hotmail.com
username: aharnett15          	password: sazcrlmxez	email: mills.jacinto@gmail.com
username: dpettet16           	password: uccbcfmejh	email: bartell.alta@gmail.com
username: vegdal17            	password: tupzfqpkgw	email: joanie.oreilly@yahoo.com
username: mrafferty18         	password: dqyodarflr	email: spencer32@yahoo.com 
username: lbarnish19          	password: ndxfnptgmg	email: oconner.kade@hotmail.com
username: aladbury1a          	password: rmciqklikw	email: kuphal.howard@hotmail.com
username: jciubutaro1b        	password: ayekwqedqd	email: belle.conroy@gmail.com
username: sboraston1c         	password: adeifwueij	email: marilie17@yahoo.com 
username: degentan1d          	password: aiuwusnqcy	email: leatha62@hotmail.com
username: tweatherburn1e      	password: wyrifwbhtf	email: baumbach.rene@yahoo.com
username: rsparway1f          	password: vqzxzuaaqx	email: cielo.morissette@gmail.com
username: ebaccus1g           	password: ldcpxmzxpd	email: oberbrunner.kane@hotmail.com
username: mgedling1h          	password: trtpqavwzj	email: purdy.cielo@yahoo.com
username: mjurs1i             	password: zmaexaowkk	email: hills.porter@hotmail.com
username: mkempton1j          	password: xiltgowtav	email: armstrong.antonina@hotmail.com
username: smacsweeney1k       	password: huwkdsgokg	email: moriah22@hotmail.com
username: welie1l             	password: wrmstytdfq	email: rashad38@hotmail.com
username: rpentland1m         	password: gobtuqjzyo	email: lionel.muller@gmail.com
username: ncady1n             	password: pzuqzeoskg	email: mertz.sammie@yahoo.com
username: hbaudain1o          	password: cofroarbzy	email: eino39@gmail.com    
username: kfarrans1p          	password: dxbutssmmv	email: ymaggio@gmail.com   
username: areadett1q          	password: zjpeppgfui	email: nina.kreiger@hotmail.com
username: cspacy1r            	password: nfbvrbhtoi	email: milo84@hotmail.com  
username: jheaslip1s          	password: snyswvejby	email: miller.jackson@yahoo.com
username: cbetje1t            	password: wvlmjdgndi	email: vhoppe@yahoo.com    
username: hrue1u              	password: zlohzohzgv	email: margaret.rice@hotmail.com
username: dsnowsill1v         	password: iamjgqoxnf	email: marquardt.lura@yahoo.com
username: bcrab1w             	password: rixpokdwom	email: nader.juston@yahoo.com
username: rbidwell1x          	password: iyrwvknlfy	email: lyda.mueller@hotmail.com
username: vpalffrey1y         	password: dtrwhfshqm	email: nanderson@gmail.com 
username: dallmond1z          	password: rbhtbalcol	email: hirthe.carmela@hotmail.com
username: jwass20             	password: bzelilytel	email: bwatsica@gmail.com  
username: lsydry21            	password: jnrongbmls	email: zachary.maggio@yahoo.com
username: rashard22           	password: cclodbpjtv	email: herman.myrtis@hotmail.com
username: ddugo23             	password: mhlvcwelxx	email: rocio.skiles@yahoo.com
username: cmacsween24         	password: sooxqxqtut	email: botsford.sonya@gmail.com
username: sluna25             	password: wjakuvpngn	email: justice.abbott@gmail.com
username: mscarsbrick26       	password: gqolzwqafn	email: maryjane.marvin@gmail.com
username: ktrolley27          	password: psfyumuvwg	email: madelyn.shanahan@hotmail.com
username: mkillick28          	password: wsvgointaf	email: wilmer42@gmail.com  
username: mdougherty29        	password: rexigchilq	email: susanna83@gmail.com 
username: tgutans2a           	password: mkcdrikruv	email: ada.vonrueden@yahoo.com
username: dbrame2b            	password: byvusoukzt	email: myron42@hotmail.com 
username: mgherardi2c         	password: aprhrdlhvo	email: mylene67@gmail.com  
username: iimison2d           	password: hwpejyrmwv	email: weimann.fiona@yahoo.com
username: icridlin2e          	password: dexewjegsq	email: talon73@yahoo.com   
username: rkingswood2f        	password: vaihkklyle	email: monty33@hotmail.com 
username: ahollingshead2g     	password: ggyodrztmc	email: jenkins.danielle@gmail.com
username: fwrenn2h            	password: orumwkyako	email: nkessler@gmail.com  
username: gkieff2i            	password: bijslzfsae	email: rod33@hotmail.com   
username: asoots2j            	password: hjyckzlqtp	email: geovanni.keeling@hotmail.com
username: khamly2k            	password: rrtijrlwud	email: marty75@yahoo.com   
username: gtootin2l           	password: xmhhrdwtqg	email: gustave.predovic@gmail.com
username: tgovey2m            	password: kgcigeazyr	email: fpurdy@hotmail.com  
username: rtubble2n           	password: xwqlmocftm	email: stracke.karina@hotmail.com
username: ddonisi2o           	password: vffxjcsjqr	email: schiller.ethelyn@hotmail.com
username: tpougher2p          	password: hvciodueih	email: nasir.metz@hotmail.com
username: bbroseman2q         	password: xlcetzrlus	email: luettgen.olga@gmail.com
username: pfaithfull2r        	password: himlliglkw	email: qleannon@yahoo.com  
username: efoystone2s         	password: jsefehgknz	email: natasha.renner@yahoo.com
username: nfuentes2t          	password: mrefdtiipl	email: mante.godfrey@yahoo.com
username: ebohin2u            	password: mcazrvzyof	email: raphaelle.pollich@yahoo.com
username: fcoode2v            	password: ipgrogzmpy	email: nelson62@hotmail.com
username: gdust2w             	password: itfgalgydl	email: paucek.andreane@yahoo.com
username: afrise2x            	password: rynbgxdblo	email: upton.efren@hotmail.com
username: lbusby2y            	password: ivetdyheqw	email: garnett80@yahoo.com 
username: tarmstrong2z        	password: nvfurwsjts	email: twalter@yahoo.com   
username: lmandal30           	password: vqagtuyfne	email: schoen.noelia@yahoo.com
username: jrapsey31           	password: sywmqzijjv	email: xhettinger@yahoo.com
username: fsleeford32         	password: ocyvlbxuru	email: isabel.stoltenberg@hotmail.com
username: amacdermand33       	password: eyhuoslbch	email: gloria.beer@gmail.com
username: bbernade34          	password: lrkspvewwc	email: dorothy.johnston@gmail.com
username: fhebron35           	password: ctfivcucyf	email: jade.hyatt@hotmail.com
username: candriolli36        	password: togrnczhiw	email: hfritsch@gmail.com  
username: eterzza37           	password: haugecxegs	email: chasity.mccullough@hotmail.com
username: ggelder38           	password: asgifybwft	email: hoeger.zachary@hotmail.com
username: pdeakes39           	password: xhnzwpxyec	email: coy25@gmail.com     
username: nrobker3a           	password: smjapucreg	email: ehalvorson@yahoo.com
username: frickeard3b         	password: hrwiriypdi	email: pkreiger@hotmail.com
username: ephlippi3c          	password: gsmzpkxetl	email: dwisozk@yahoo.com   
username: rromain3d           	password: qjbtpvycsl	email: towne.andreane@gmail.com
username: elocke3e            	password: nbvygnxtfa	email: mariane.west@hotmail.com
username: wclarkewilliams3f   	password: mgaqesaqru	email: hanna.kub@gmail.com 
username: melks3g             	password: fjkulzudsc	email: ila.heaney@yahoo.com
username: cgodsmark3h         	password: jmutwglerw	email: stroman.charlotte@yahoo.com
username: yleverage3i         	password: umrvpfocyb	email: zboncak.jadyn@yahoo.com
username: cgravestone3j       	password: totuwwrlba	email: roosevelt.dach@yahoo.com
username: mwace3k             	password: crlstkumsg	email: west.benjamin@yahoo.com
username: fberetta3l          	password: tpycsevvoi	email: astrid.fritsch@hotmail.com
username: ctideswell3m        	password: xplvyzcugc	email: josianne74@yahoo.com
username: efraney3n           	password: imyhhwyitn	email: hpfeffer@yahoo.com  
username: pmelpuss3o          	password: eezykskofo	email: pollich.amelia@yahoo.com
username: tgoreway3p          	password: skoucxbhul	email: jeremie.ferry@hotmail.com
username: astains3q           	password: reksgepaek	email: monica96@yahoo.com  
username: mmccloch3r          	password: jvmueycbgh	email: louvenia39@gmail.com
username: rdubarry3s          	password: qzfpsvwoed	email: oosinski@gmail.com  
username: eosmon3t            	password: qucuztojqq	email: pcrist@gmail.com    
username: lcicchelli3u        	password: ndthgjxmtj	email: schinner.freida@hotmail.com
username: nivanin3v           	password: hvnhudfphv	email: eula.kris@gmail.com 
username: fscaife3w           	password: vsghzypnke	email: justen.watsica@gmail.com
username: oroantree3x         	password: ikwtylnhwa	email: cecil73@hotmail.com 
username: wcotgrave3y         	password: rjffsnyxcd	email: ismael.koss@hotmail.com
username: slett3z             	password: kvxsbwjmcz	email: ssimonis@hotmail.com
username: dbolitho40          	password: ujoudbgkoy	email: ryley.vonrueden@hotmail.com
username: bover41             	password: yscxlqvxmu	email: jordon.padberg@gmail.com
username: rgynn42             	password: vihiuculuz	email: antonetta.koss@hotmail.com
username: smathes43           	password: ukqeotoomi	email: hroob@yahoo.com     
username: dphateplace44       	password: crnkokauah	email: bkuvalis@gmail.com  
username: eannable45          	password: rtzfyjyocm	email: hardy.jakubowski@gmail.com
username: ppainswick46        	password: amtvgxfoli	email: marlee.becker@yahoo.com
username: esellek47           	password: twgidutkha	email: judd.halvorson@yahoo.com
username: dslight48           	password: wkpxoyeqrb	email: kunde.murl@yahoo.com
username: bgorrie49           	password: dwuefvfjxp	email: anabel05@gmail.com  
username: rgerrietz4a         	password: tdducsatek	email: myrna.bins@hotmail.com
username: lmoverley4b         	password: euejroygji	email: osmith@hotmail.com  
username: ybruyet4c           	password: scjlnbgxbk	email: bhuel@gmail.com     
username: bhorrod4d           	password: gqomcudvxc	email: vanessa82@yahoo.com 
username: abarthorpe4e        	password: wsfhuladvr	email: jay.medhurst@hotmail.com
username: dffrenchbeytagh4f   	password: nknaovcgtu	email: adriana15@hotmail.com
username: fmessager4g         	password: vwlwvnqkgn	email: lockman.emory@yahoo.com
username: wbrimming4h         	password: iwrwfxcxrv	email: xziemann@yahoo.com  
username: agason4i            	password: uokbsthwkc	email: mward@hotmail.com   
username: lmackin4j           	password: vxyworprsm	email: nchristiansen@yahoo.com
username: rdoget4k            	password: lzvledvhhh	email: thand@yahoo.com     
username: fsayers4l           	password: mejpzxpndt	email: cormier.federico@hotmail.com
username: vbaine4m            	password: ayrllgrtip	email: graham.yazmin@hotmail.com
username: rmulqueen4n         	password: rgutdiyrqe	email: destiny.bartoletti@gmail.com
username: dmcclaren4o         	password: euxfktamfu	email: nitzsche.camden@gmail.com
username: swyson4p            	password: qayxzfmwpu	email: ularson@gmail.com   
username: kburchnall4q        	password: sfntwqzcur	email: yjenkins@yahoo.com  
username: jhebblewaite4r      	password: bythcqbgzj	email: abby07@hotmail.com  
username: hbartosik4s         	password: fcvcvgygpb	email: garrick.mcclure@yahoo.com
username: kpeinton4t          	password: hzobhtomwj	email: helga31@gmail.com   
username: hmarchent4u         	password: touxtddprv	email: tillman.akeem@yahoo.com
username: dobeirne4v          	password: ptrgsecvfk	email: millie.bradtke@gmail.com
username: vbrettel4w          	password: suklyggaho	email: swiegand@yahoo.com  
username: ndrains4x           	password: wrwlqlfuhn	email: korbin.okeefe@yahoo.com
username: aorrum4y            	password: lnrqytjljt	email: ikeeling@yahoo.com  
username: wlambie4z           	password: ubslqeefki	email: greenholt.gus@yahoo.com
username: givanitsa50         	password: bziimfvdoz	email: johns.vivian@hotmail.com
username: shuckabe51          	password: pxuqujmzoj	email: gail87@yahoo.com    
username: gdalliston52        	password: zsrmptefnc	email: huel.jensen@yahoo.com
username: akittel53           	password: cvgufgbuxg	email: sbednar@hotmail.com 
username: mucceli54           	password: buuroescac	email: fpouros@hotmail.com 
username: kberthomieu55       	password: pxurclgtbe	email: finn08@yahoo.com    
username: ghaggerwood56       	password: tmjhdeebgt	email: gregoria66@gmail.com
username: zcoffey57           	password: nwoqwwflbh	email: fpfeffer@yahoo.com  
username: lpurkiss58          	password: gwzdfwxauq	email: ustark@gmail.com    
username: jgolston59          	password: xrvvzhiyut	email: ada.weimann@yahoo.com
username: vklawi5a            	password: oeyyfxndob	email: frederique.grady@gmail.com
username: biannini5b          	password: pfujgxjmwl	email: akeebler@hotmail.com
username: ftitchener5c        	password: chbtnizokj	email: lynch.nico@yahoo.com
username: bbeane5d            	password: bymbkwjzrk	email: shirley.feeney@hotmail.com
username: rpaolucci5e         	password: chtrlsyaaq	email: nader.sterling@yahoo.com
username: hblint5f            	password: bshvjzrxff	email: oquitzon@hotmail.com
username: pcatlette5g         	password: towveassqd	email: berge.haskell@yahoo.com
username: beusden5h           	password: vrrupewkxy	email: bernadine.lind@hotmail.com
username: grubinsky5i         	password: qlcwcskwbk	email: myrtle41@hotmail.com
username: lfishpoole5j        	password: yhurbddwzf	email: tconroy@hotmail.com 
username: ccubbon5k           	password: xqtqroepba	email: jjohnson@hotmail.com
username: icastel5l           	password: slbwdwaqrg	email: velma.schuppe@hotmail.com
username: cemms5m             	password: tzmbhdnblo	email: gabriella62@yahoo.com
username: rfritche5n          	password: aoeusmqkli	email: kuphal.javonte@gmail.com
username: pgunby5o            	password: injortcxgy	email: euna72@hotmail.com  
username: mbutterwick5p       	password: tinyrvaiir	email: mcglynn.michaela@yahoo.com
username: aservante5q         	password: dugsoyfojl	email: tkeebler@gmail.com  
username: cleworthy5r         	password: tmxarwiqgi	email: kayleigh45@hotmail.com
username: escargill5s         	password: apmxjeozru	email: amina.cormier@yahoo.com
username: bbratchell5t        	password: mfyichxelt	email: qmurazik@yahoo.com  
username: fnuccii5u           	password: qsglnpbrvi	email: kylie.frami@yahoo.com
username: hstilwell5v         	password: cmfwcbgaax	email: dorn@gmail.com      
username: kkyndred5w          	password: jjujrsgwtz	email: idell15@gmail.com   
username: acranshaw5x         	password: cxrhkcuxrw	email: elsie76@gmail.com   
username: cwardroper5y        	password: grufqshdrr	email: wuckert.wyman@gmail.com
username: cforsey5z           	password: abyywhjxqp	email: qschmidt@gmail.com  
username: lreide60            	password: gbgaygrmym	email: murl30@gmail.com    
username: kstango61           	password: ncbkzpcqjo	email: fay.elwyn@hotmail.com
username: sswan62             	password: wnythwtajh	email: wilford.dickinson@yahoo.com
username: rswash63            	password: ectberaaae	email: thora98@gmail.com   
username: jfliege64           	password: vnmlbkhrah	email: marquardt.melba@yahoo.com
username: nsolly65            	password: vuhumxgwte	email: vboehm@yahoo.com    
username: whitscher66         	password: pqpssxthba	email: eleonore89@yahoo.com
username: ccottam67           	password: ldidjuuojj	email: schowalter.ike@gmail.com
username: rmcilmurray68       	password: tzzovtxtgu	email: casper.simonis@gmail.com
username: hmoatt69            	password: seoyzuqzdx	email: scrist@yahoo.com    
username: khouldin6a          	password: youkfcpfcu	email: cesar.yundt@gmail.com
username: mzorzenoni6b        	password: gnepkdevaq	email: leannon.crystel@hotmail.com
username: mhaill6c            	password: pjnfldkahq	email: josefa.pollich@gmail.com
username: cdalgarno6d         	password: opcwwtutjg	email: maggio.elinore@yahoo.com
username: dlaible6e           	password: opqogztsnl	email: jack84@gmail.com    
username: lferrick6f          	password: vtnhagvpas	email: benedict.waters@gmail.com
username: jbaldetti6g         	password: fthiapkwef	email: gaylord.conn@gmail.com
username: tcrimin6h           	password: knjglhelbm	email: renee37@hotmail.com 
username: vidill6i            	password: lexoqxouwe	email: sheidenreich@gmail.com
username: mbowdrey6j          	password: iqeriislto	email: maureen38@yahoo.com 
username: cgrimsdith6k        	password: gbffgyrqit	email: kylee18@gmail.com   
username: amckinless6l        	password: pfgqaobovv	email: harrison.herzog@gmail.com
username: bklimek6m           	password: bknptqtree	email: issac.howe@gmail.com
username: edulany6n           	password: wkmumdeidb	email: ashtyn.stark@yahoo.com
username: nwassung6o          	password: wzukyonsyt	email: gay.wunsch@gmail.com
username: sthewles6p          	password: hwxtkpjmbm	email: lourdes64@hotmail.com
username: ehowerd6q           	password: ykboczajiu	email: borer.salvador@hotmail.com
username: adominy6r           	password: tiifbmxhro	email: jesse.maggio@gmail.com
username: lmcgready6s         	password: ykbeawgaml	email: bruce.durgan@gmail.com
username: asimonin6t          	password: pvxvrpnqwd	email: dallin.durgan@hotmail.com
username: rdavidoff6u         	password: fipvxxgjcs	email: creola03@hotmail.com
username: ssanchiz6v          	password: wvsripnrbn	email: dooley.cletus@yahoo.com
username: siggo6w             	password: afxpthnwvx	email: elijah73@hotmail.com
username: wboulden6x          	password: woxrhyqfnb	email: miguel.beier@yahoo.com
username: rspringett6y        	password: vkrhfecphk	email: alubowitz@hotmail.com
username: jloughead6z         	password: gzevjrcgbr	email: lauren06@yahoo.com  
username: gsaffer70           	password: ajlvkpbcnv	email: earnestine.greenholt@gmail.com
username: gjeduch71           	password: sorcnxsrda	email: pzieme@yahoo.com    
username: vmusselwhite72      	password: emvtywjhrs	email: uwuckert@yahoo.com  
username: cdennidge73         	password: ibosvxwvbx	email: kertzmann.thea@yahoo.com
username: eyellop74           	password: qmcuvffeut	email: wlangworth@yahoo.com
username: rbraysher75         	password: savvyfelev	email: gwen87@yahoo.com    
username: pmallows76          	password: xfoynuauuc	email: zelma.bauch@yahoo.com
username: mthreadgold77       	password: zwaznguauk	email: considine.damian@gmail.com
username: mmcconnal78         	password: rakittossx	email: leuschke.remington@hotmail.com
username: lwinsper79          	password: wixnmzhlij	email: reilly.destiny@gmail.com
username: sewert7a            	password: rzufhqzxyy	email: cwilkinson@gmail.com
username: alimprecht7b        	password: adqakxqbeo	email: rtillman@hotmail.com
username: mthaim7c            	password: vngdrrmdls	email: zrosenbaum@gmail.com
username: bmacgilrewy7d       	password: zrieyetbol	email: barbara.jast@gmail.com
username: jclemmey7e          	password: zsvgclvbul	email: hammes.kip@hotmail.com
username: dpezey7f            	password: wdsirimnwc	email: gvon@yahoo.com      
username: ghowton7g           	password: qgrnlaykbf	email: bashirian.kylie@gmail.com
username: efarrow7h           	password: feaztaiuum	email: fcasper@hotmail.com 
username: wcamilli7i          	password: evqqrxelpj	email: nienow.heath@yahoo.com
username: erichel7j           	password: zexbwtlqog	email: charlene34@yahoo.com
username: uchezelle7k         	password: omhcenwitl	email: weber.candelario@gmail.com
username: noseman7l           	password: enpawpjvcz	email: fiona46@yahoo.com   
username: clathleiffure7m     	password: lkxfgcwhrv	email: pollich.jeramie@hotmail.com
username: rmulford7n          	password: svayqawrtr	email: maya51@gmail.com    
username: socurrine7o         	password: rdhgrpdgxu	email: ernestina.witting@gmail.com
username: jvallance7p         	password: pncfvspjrv	email: berge.cecil@hotmail.com
username: mramplee7q          	password: atvceotrhv	email: selena31@yahoo.com  
username: jscruby7r           	password: hapwxcpgaj	email: romaguera.garrison@yahoo.com
username: hklinck7s           	password: rpzaqmkrax	email: dzboncak@gmail.com  
username: egotcliffe7t        	password: dlfepcdpju	email: brekke.dakota@hotmail.com
username: mgervaise7u         	password: cbmeypbeyw	email: nbauch@yahoo.com    
username: apretsel7v          	password: azsacixnev	email: clementine83@hotmail.com
username: neastman7w          	password: jmnsohtusp	email: maybelle.homenick@yahoo.com
username: evolage7x           	password: wlytjvjksh	email: hoppe.titus@gmail.com
username: dwitherop7y         	password: ydmgsujwaj	email: benjamin.rowe@yahoo.com
username: fbilovsky7z         	password: ijsxilrqvw	email: geovanny30@yahoo.com
username: blucy80             	password: vfewobzbpn	email: nikolaus.mafalda@hotmail.com
username: jtitchmarsh81       	password: hkoflsmbnj	email: nestor.stoltenberg@gmail.com
username: landrews82          	password: sxeyhvglnq	email: bins.efren@yahoo.com
username: cremmers83          	password: xexmiqiqfx	email: lily.tromp@hotmail.com
username: lbaldacco84         	password: imxmuqlxdn	email: hherzog@gmail.com   
username: etardiff85          	password: dvcztbjdzt	email: lorena.purdy@yahoo.com
username: jbrady86            	password: lvrdkauuvx	email: boyle.clementine@yahoo.com
username: jfaughey87          	password: jciqmpkyze	email: ledner.andreanne@yahoo.com
username: mzammett88          	password: odeuneqmqt	email: fadel.demetrius@yahoo.com
username: kpoznan89           	password: izeescrepq	email: zankunding@gmail.com
username: rceschi8a           	password: wlltzyqnbc	email: awolf@yahoo.com     
username: ahamilton8b         	password: ivevntliub	email: bert50@gmail.com    
username: dmclaine8c          	password: phvrhwhgtx	email: blaze.treutel@gmail.com
username: mheersema8d         	password: etrzzxyzbp	email: shea48@gmail.com    
username: rallanby8e          	password: nlmnnmembq	email: iemard@gmail.com    
username: amarrow8f           	password: qubflwuvia	email: xgleason@gmail.com  
username: nbaldassi8g         	password: aznlidszix	email: else.pfannerstill@gmail.com
username: mbodocs8h           	password: sfetgiyhxp	email: della18@yahoo.com   
username: tportch8i           	password: oescowgwxv	email: gerson89@gmail.com  
username: kbielfeld8j         	password: lkhrlwgoat	email: kunde.lilly@gmail.com
username: mmease8k            	password: umgmonclxm	email: chase99@yahoo.com   
username: bhonywill8l         	password: wfgdrmaaau	email: ybeatty@gmail.com   
username: dmcphee8m           	password: wdxtjiyxbw	email: jessika.kilback@yahoo.com
username: freeme8n            	password: ugavcxrnzd	email: mjacobs@hotmail.com 
username: akryska8o           	password: socdtntmqa	email: priscilla.lindgren@yahoo.com
username: eseak8p             	password: vjnvuipfsp	email: hnicolas@yahoo.com  
username: mproffer8q          	password: qcmrciezom	email: verna43@gmail.com   
username: sgaitung8r          	password: rnbpnijtwg	email: howell.laron@yahoo.com
username: lstenbridge8s       	password: ihitclylqb	email: breana.carter@gmail.com
username: ccoils8t            	password: rbhdttsggs	email: peggie16@gmail.com  
username: tworts8u            	password: uqghhqcvqp	email: effertz.jada@gmail.com
username: jpolamontayne8v     	password: jltxochusw	email: domingo30@yahoo.com 
username: kfedynski8w         	password: egdqoddrzz	email: ryan.ramona@hotmail.com
username: ckinlock8x          	password: qhrnzovflv	email: lschoen@yahoo.com   
username: ldransfield8y       	password: fwhgefpinz	email: connelly.jamil@hotmail.com
username: nschleicher8z       	password: rkedxdsfvg	email: marcelle.hahn@yahoo.com
username: kbrookes90          	password: zcgyyqqgcn	email: mona19@yahoo.com    
username: hyanin91            	password: pawstujwcx	email: bode.kurt@gmail.com 
username: pgolding92          	password: gpsdiekhva	email: koch.eleonore@hotmail.com
username: ktame93             	password: oykmtsciyo	email: imelda.gerhold@yahoo.com
username: cposselt94          	password: mlqqtkivnl	email: blick.viva@gmail.com
username: mbaccup95           	password: cnavxurgkh	email: keely47@hotmail.com 
username: khenriet96          	password: vvpkyphvls	email: watsica.orlo@hotmail.com
username: sbowland97          	password: wvuoxczuvv	email: jessy.kreiger@yahoo.com
username: hsnoddin98          	password: mkvdaqljvc	email: torphy.jamie@yahoo.com
username: etilliards99        	password: fqvinrcrqp	email: zrussel@gmail.com   
username: ccochran9a          	password: ubhoyxcigh	email: margie13@yahoo.com  
username: alawlee9b           	password: edfjxgqatf	email: omari91@yahoo.com   
username: pdeavin9c           	password: jxwveosxlu	email: ffisher@hotmail.com 
username: eheadford9d         	password: grgkewntps	email: kiara56@yahoo.com   
username: abebbington9e       	password: aypehomfej	email: duane.bode@hotmail.com
username: ashipton9f          	password: upanemqhhh	email: orlando58@gmail.com 
username: bgareisr9g          	password: vdlqvkobdt	email: nikolaus.waylon@hotmail.com
username: cnew9h              	password: xscoflwqyy	email: pjacobi@gmail.com   
username: gcarey9i            	password: vzjhejhgps	email: ckuhlman@gmail.com  
username: scoggill9j          	password: twaayuxoyk	email: gcollier@hotmail.com
username: lcrippin9k          	password: jbkukqgoru	email: jarrett24@yahoo.com 
username: dosgordby9l         	password: sikblikepm	email: liliane.kohler@hotmail.com
username: esaunper9m          	password: srdddudohy	email: kian.schulist@hotmail.com
username: kkeitley9n          	password: zeizljrexs	email: dannie30@hotmail.com
username: zdowbekin9o         	password: kxtooknwgl	email: kelly27@yahoo.com   
username: hlammert9p          	password: fklmsspypw	email: wellington42@hotmail.com
username: hteresi9q           	password: cfghnzilez	email: arnoldo06@gmail.com 
username: lrohan9r            	password: gitiijzxtt	email: dane41@gmail.com    
username: cmcpartling9s       	password: zkajugvmak	email: jane85@gmail.com    
username: dfillery9t          	password: xjfqfdtrvz	email: kozey.uriah@gmail.com
username: jmiddleditch9u      	password: iyqibmesjy	email: katelin.armstrong@gmail.com
username: emace9v             	password: uhkxpkwdrg	email: keagan66@yahoo.com  
username: vratnage9w          	password: tdytaflnlc	email: lakin.nelda@yahoo.com
username: amartinek9x         	password: ivvubcsohl	email: fnolan@yahoo.com    
username: jdrogan9y           	password: qxrglzmdof	email: pacocha.randy@gmail.com
username: cceaser9z           	password: blzeldmpvm	email: retha96@hotmail.com 
username: jsexceya0           	password: bbbciyirki	email: kathryn49@yahoo.com 
username: kcasha1             	password: ujalhluvpj	email: stiedemann.samantha@gmail.com
username: eohalligana2        	password: eayvzluret	email: alicia.runte@hotmail.com
username: njanewaya3          	password: ccuwtkwrck	email: woodrow.rolfson@gmail.com
username: mroberdsa4          	password: rraozvwofz	email: hickle.icie@gmail.com
username: lpetrova5           	password: xxataihidn	email: alessandro68@yahoo.com
username: afullerlovea6       	password: qfyuonvsas	email: adolphus.price@hotmail.com
username: ckarolya7           	password: wjpmkgcbya	email: nprosacco@gmail.com 
username: jmaccranna8         	password: havmbhnqad	email: oleta.kihn@gmail.com
username: ejacquemya9         	password: zebytfbhyh	email: kallie.white@gmail.com
username: wcleveleyaa         	password: djhporiguw	email: xkiehn@yahoo.com    
username: caudissab           	password: bpctcvooxj	email: gleannon@gmail.com  
username: canandac            	password: nghdclwrik	email: yschuster@gmail.com 
username: ffarquharsonad      	password: rdetcjiwby	email: jreinger@gmail.com  
username: mrayhillae          	password: jaexddtivh	email: bednar.taurean@gmail.com
username: pfollenaf           	password: xipacdsgil	email: mccullough.aglae@gmail.com
username: pmathiesonag        	password: tvjeayocwh	email: maximilian91@hotmail.com
username: msteuhlmeyerah      	password: itypmhuqot	email: ykoepp@gmail.com    
username: acuphusai           	password: xmuscgvgkd	email: gilberto60@yahoo.com
username: asalsburyaj         	password: bvnvlpygqm	email: ilene.deckow@hotmail.com
username: nbaldackak          	password: ozcufgcyzn	email: ewell00@gmail.com   
username: jgaskingal          	password: qdtixyjvnf	email: dernser@hotmail.com 
username: fnareyam            	password: quzssbsmvo	email: zmueller@gmail.com  
username: mswadlingean        	password: dsmptpzzcv	email: dessie44@yahoo.com  
username: aconradao           	password: vdeuexeuvt	email: lelia.keebler@yahoo.com
username: eguthersonap        	password: idlyqwrbov	email: pwalter@gmail.com   
username: coliveraaq          	password: izteinuish	email: emilio15@gmail.com  
username: ceilertar           	password: ojcmyexmzt	email: kunde.jettie@yahoo.com
username: bdaymondas          	password: nylojhmzyj	email: bconnelly@hotmail.com
username: hlandsmanat         	password: qdczamtauz	email: agnes.hill@hotmail.com
username: czorzinau           	password: tupznaaxbw	email: dawn82@hotmail.com  
username: asillyav            	password: dohoagewte	email: emmy.satterfield@gmail.com
username: ksawbridgeaw        	password: mkaejittyw	email: adicki@yahoo.com    
username: kallattax           	password: gflrfeijdy	email: hackett.sasha@gmail.com
username: dcasaroliay         	password: knfcvvpnzp	email: dicki.alfred@hotmail.com
username: lshannahanaz        	password: ytvwkahgea	email: gisselle.littel@yahoo.com
username: acaldronib0         	password: tkcsjjcuza	email: vandervort.lea@gmail.com
username: vcollerdb1          	password: fsrnaxoxuy	email: serenity.stroman@hotmail.com
username: uaustickb2          	password: npeoqeiskw	email: iklocko@gmail.com   
username: fodroughtb3         	password: omypqagyvz	email: nnitzsche@yahoo.com 
username: kbuchamb4           	password: xragbvbizb	email: tschimmel@hotmail.com
username: ccarollb5           	password: pkxgyhkfpt	email: ubrakus@hotmail.com 
username: fwintertonb6        	password: gjfpavqvgx	email: cecil.kautzer@gmail.com
username: wwaterfieldb7       	password: jihgqopkyv	email: zmohr@hotmail.com   
username: ajimenob8           	password: akycgzuyic	email: marcelo76@yahoo.com 
username: gtruittb9           	password: oqedhdgwps	email: trantow.abbigail@hotmail.com
username: czuanelliba         	password: qqrduicesq	email: dante88@yahoo.com   
username: igrigsonbb          	password: dfzhkogeer	email: gweimann@gmail.com  
username: djantonbc           	password: jbowomxdrb	email: audie17@hotmail.com 
username: hheadybd            	password: ymnsjiwqpk	email: winston.lehner@yahoo.com
username: nwinpennybe         	password: khidlcahvi	email: tanner.lehner@hotmail.com
username: ofindersbf          	password: wbihglijwn	email: shuels@hotmail.com  
username: cciciurabg          	password: puwiwfvrpu	email: franco.jast@hotmail.com
username: llarrosabh          	password: wrfzgclebr	email: dasia.aufderhar@yahoo.com
username: eshipseybi          	password: vkhjnuqmir	email: eichmann.colin@yahoo.com
username: eleythleybj         	password: kftkpauhay	email: ondricka.moriah@yahoo.com
username: jcunradibk          	password: ebsudybxem	email: frederic.block@yahoo.com
username: vlangthornebl       	password: gcyixxwrib	email: olen67@hotmail.com  
username: nplankbm            	password: egqebiqezl	email: ezekiel.lowe@hotmail.com
username: kglazyerbn          	password: jjtsrbzwzz	email: nullrich@yahoo.com  
username: hschukraftbo        	password: uiaqwwknml	email: sammie54@yahoo.com  
username: psaxonbp            	password: nclkwodafc	email: millie.ferry@yahoo.com
username: pdrewettbq          	password: qndnitvnno	email: qkirlin@gmail.com   
username: lhaywoodbr          	password: noinxvnjub	email: zturner@hotmail.com 
username: bkeeblebs           	password: pxhdedauxy	email: bernhard.kristin@gmail.com
username: jwildbloodbt        	password: tvtyysfiaf	email: uhowell@hotmail.com 
username: lfettesbu           	password: ydldhzxigg	email: merl71@yahoo.com    
username: alongthornebv       	password: qvpzlsxmbu	email: auer.dalton@hotmail.com
username: akildalebw          	password: mwjnflwkbn	email: mbarrows@yahoo.com  
username: mmartinovskybx      	password: slvbjusdgs	email: xcrooks@gmail.com   
username: rquantrillby        	password: urfzgjhhkx	email: kayli.nader@gmail.com
username: dratazzibz          	password: govvpfwbet	email: vvolkman@gmail.com  
username: cperronec0          	password: atugbmtvdo	email: ruth.rogahn@hotmail.com
username: zsultanac1          	password: nolvexxbpo	email: jody.kris@hotmail.com
username: nfrusherc2          	password: hyszednrje	email: korey.jast@yahoo.com
username: pstephensonc3       	password: rckemilufc	email: mckenna.brakus@gmail.com
username: hdmychc4            	password: uguutlamld	email: philip.kuvalis@yahoo.com
username: avankinc5           	password: xhbcczjrhj	email: nskiles@hotmail.com 
username: chulkc6             	password: iehvcymlyg	email: ifisher@gmail.com   
username: pbeckinghamc7       	password: phgbojhwkx	email: irwin.block@hotmail.com
username: mweldrickc8         	password: zsoljdvbej	email: sbailey@gmail.com   
username: mchristoforouc9     	password: ucilquzzce	email: treichert@yahoo.com 
username: dgammackca          	password: nskakfeuyf	email: marcelo34@gmail.com 
username: cscripturecb        	password: hjtuciauhk	email: koelpin.lexie@yahoo.com
username: erhoadescc          	password: tthkcrutxv	email: phalvorson@yahoo.com
username: claythamcd          	password: eipciduseh	email: gage.schroeder@gmail.com
username: kstaresce           	password: taxfkjsljg	email: madie71@yahoo.com   
username: jstidevercf         	password: ekdtptzqum	email: maggie.bergstrom@gmail.com
username: britchingscg        	password: pquxoosznd	email: crooks.junior@hotmail.com
username: kortigerch          	password: aytnxnoxef	email: vella.morar@gmail.com
username: pmackaigci          	password: pcowmvidek	email: drew52@yahoo.com    
username: dcowdreycj          	password: dmkdriqyex	email: ckonopelski@yahoo.com
username: ahaspineallck       	password: zqunuymdwq	email: xchristiansen@gmail.com
username: ccliffcl            	password: bpkastwtwl	email: zdietrich@hotmail.com
username: cmingaycm           	password: nsgydnynjw	email: ufritsch@hotmail.com
username: ckeningtoncn        	password: npngtfnylr	email: donny60@hotmail.com 
username: ebumco              	password: rpawmzpdhq	email: nferry@yahoo.com    
username: jiveanscp           	password: oynpfxjdqo	email: jaltenwerth@gmail.com
username: pcoppincq           	password: jzisymvdho	email: lindgren.nichole@yahoo.com
username: hbramallcr          	password: axvimtenot	email: patricia.feeney@yahoo.com
username: eklausencs          	password: tzzcfmpgfw	email: zieme.antonette@yahoo.com
username: atilliardsct        	password: fpatyfpqjz	email: stark.lance@gmail.com
username: jpettegreecu        	password: egggauskdn	email: donnelly.brenna@hotmail.com
username: jboothebiecv        	password: xskmatmpge	email: vince04@gmail.com   
username: cjankucw            	password: brwoajbbez	email: uhamill@yahoo.com   
username: tmatusevichcx       	password: xwnyypjjpa	email: cali.schultz@yahoo.com
username: cgosslingcy         	password: bgquwbganj	email: kgleason@hotmail.com
username: kluiscz             	password: vpyinuzfmy	email: brolfson@hotmail.com
username: morsd0              	password: opcmzhsyqc	email: legros.eleanora@gmail.com
username: cmoulsdalld1        	password: hobhwrarhw	email: fbarrows@gmail.com  
username: rchapelhowd2        	password: brmvmkudcm	email: nfadel@hotmail.com  
username: lgoodliffed3        	password: qtmkvtmhol	email: nathanael21@gmail.com
username: mgiggd4             	password: tkdwkjjlcg	email: hattie.legros@gmail.com
username: sbozworthd5         	password: metnnffxot	email: spouros@gmail.com   
username: cmceneryd6          	password: joglxmteeq	email: stracke.cristina@yahoo.com
username: vbarded7            	password: vemzbcyirv	email: ymedhurst@hotmail.com
username: clummusd8           	password: kothehizww	email: mozelle.waters@hotmail.com
username: dhundleyd9          	password: oofdbvydhy	email: jaskolski.madisyn@gmail.com
username: kdunkerkda          	password: fwnjfbpxwe	email: maggio.katharina@hotmail.com
username: amaldendb           	password: mucafgmqac	email: marta.mosciski@gmail.com
username: zwilgardc           	password: zvgtgidons	email: gkshlerin@hotmail.com
username: dpyrkedd            	password: lrruxlnhcb	email: goyette.vincenza@hotmail.com
username: vdurdyde            	password: hvagyiezln	email: tomas23@yahoo.com   
username: lzottodf            	password: rhqbizvdpe	email: lakin.mylene@hotmail.com
username: dtilstondg          	password: flymdmcnag	email: sydni.gorczany@yahoo.com
username: mfairdh             	password: tycmdggybr	email: parker.ashley@gmail.com
username: tfeenandi           	password: pvhtyvttuz	email: nels.jacobson@gmail.com
username: dgirodindj          	password: bemyctmkpa	email: yasmin56@hotmail.com
username: cparrendk           	password: hkeoghxzhl	email: runolfsson.westley@yahoo.com
username: tlashamdl           	password: sgfrnwutcg	email: diamond52@yahoo.com 
username: llivickdm           	password: gwkccbdzzm	email: price.sabryna@yahoo.com
username: cpetroldn           	password: utzwszbmol	email: mante.norbert@hotmail.com
username: bhabbesdo           	password: mehnsebuuc	email: flatley.candida@yahoo.com
username: rsteersdp           	password: qsdbxfeqnl	email: junius13@hotmail.com
username: nmarwooddq          	password: gluhemvdek	email: ypollich@hotmail.com
username: kshoemarkdr         	password: xsccophroy	email: upadberg@gmail.com  
username: lbulcockds          	password: ivsfrtoblz	email: dejah27@hotmail.com 
username: mpettingilldt       	password: arcygcsjic	email: gaylord.gavin@gmail.com
username: aglitherowdu        	password: xdaxvpvwof	email: okuneva.nash@gmail.com
username: jgeipeldv           	password: frgkzoqdiv	email: zachery87@gmail.com 
